{
	"tileConfigName": "default", 
	"width": 10, 
	"height": 8, 
	"tiles": [
		[ 1, 2, 2,10, 2, 2, 2, 2, 2, 3],
		[ 4, 0, 0,14, 0, 0, 0, 0, 0, 5],
		[ 4, 0, 0,14, 0, 0, 0, 0, 0, 5],
		[11,18,17, 9,15,18,17,21,15,12],
		[ 4, 0, 0,14, 0, 0, 0,14, 0, 5],
		[ 4, 0, 0,16, 0, 0, 0,16, 0, 5],
		[ 4, 0, 0,19, 0, 0, 0,19, 0, 5],
		[ 6, 7, 7,13, 7, 7, 7,13, 7, 8]
	]
}